Ниже представлен алфавитный список стран мира, в который включена 251 страна, в том числе:
195 независимых государств (см. также Список государств):
193 государства-члена ООН;
2 наблюдателя:
Святой Престол (субъект в статусе persona sui generis, владеющий собственной вспомогательной суверенной территорией Ватикан);
Государство Палестина (формирование государства предусматривается на территории Западного берега реки Иордан и Сектора Газа);

Государства с неопределённым статусом (10):
6 государств, не входящих в ООН, но официально признанных одним или некоторыми государствами-членами ООН (Непризнанные и частично признанные государства):
Республика Абхазия;
Китайская Республика;
Республика Косово;
Сахарская Арабская Демократическая Республика;
Турецкая Республика Северного Кипра;
Республика Южная Осетия;

4 государства, не входящие в ООН, не признанные ни одной страной-членом ООН, но признанные некоторыми частично признанными государствами:
Донецкая Народная Республика;
Луганская Народная Республика;
Нагорно-Карабахская Республика;
Приднестровская Молдавская Республика;

Владения (имеющие постоянное, коренное население и собственное гражданство) (46):
3 территории с особым статусом, оговоренным в международных соглашениях:
Аландские острова (Финляндия);
Гонконг (Сянган) (Китайская Народная Республика);
Макао (Аомынь) (Китайская Народная Республика);

35 зависимых территорий, имеющих постоянное население:
3 внешних территории Австралии: Кокосовые (Килинг) острова, остров Норфолк и остров Рождества;
3 коронные земли Великобритании: Гернси, Джерси и остров Мэн;
10 заморских территорий Великобритании: Ангилья, Бермудские острова (Бермуды), Британские Виргинские острова, Гибралтар, Каймановы острова, Монтсеррат, острова Питкэрн, острова Святой Елены, Вознесения и Тристан-да-Кунья, Тёркс и Кайкос, Фолклендские (Мальвинские) острова;
2 территории (автономных региона) Дании: Гренландия и Фарерские острова;
3 заморские (автономные) территории Нидерландов: Аруба, Кюрасао и Синт-Мартен;
2 самоуправляющихся государственных образования в свободной ассоциации c Новой Зеландией: острова Кука и Ниуэ (Савидж);
1 зависимая территория Новой Зеландии: Токелау;
5 заморских владений (неприсоединённых территорий) США: Американские Виргинские острова, Американское Самоа, Гуам, Пуэрто-Рико и Северные Марианские острова;
5 заморских сообществ Франции: Сен-Бартельми, Сен-Мартен, Сен-Пьер и Микелон, Уоллис и Футуна и Французская Полинезия;
1 заморское особое административно-территориальное образование с особым статусом Франции: Новая Каледония;

8 заморских территорий, считаемых неотъемлемой частью соответствующих государств, но при этом иногда относящихся к категории отдельных владений (к примеру, в Общероссийском классификаторе стран мира ОКСМ):
3 особые (заморские) общины Нидерландов: Бонэйр, Саба и Синт-Эстатиус;
5 заморских департаментов и регионов Франции: Гваделупа, Майотта, Мартиника, Реюньон и Французская Гвиана.

В данный список не включены:
20 зависимых территорий, не имеющих постоянного населения:
9 внешних малых островов США: о. Бейкер, о. Джарвис, атолл Джонстон, риф Кингмен, атолл Мидуэй, о. Навасса, атолл Пальмира, о. Уэйк, о. Хаулэнд (иногда указываются ещё две территории — банки Бахо-Нуэво и Серранилья);
3 заморские территории Великобритании: Акротири и Декелия, Британская территория в Индийском океане, Южная Георгия и Южные Сандвичевы острова;
3 внешних территории Австралии: Острова Ашмор и Картье, Территория островов Кораллового моря, Остров Херд и острова Макдональд;
3 зависимых территории Норвегии: Остров Буве, Шпицберген, Ян-Майен;
2 заморских особых административно-территориальных образования с особым статусом Франции: Остров Клиппертон и Французские Южные и Антарктические территории.

Прочие территории, не являющиеся официально признанными государствами или владениями государств:
6 заморских территорий, считаемых неотъемлемой частью соответствующих государств, но территориально значительно удаленных от основной части государства (в частности, относящихся к другой части света):
заморский штат США: Гавайи;
3 территории Испании в Африке: Канарские острова; автономные города-полуанклавы Сеута и Мелилья, а также другие малые острова, входящие в так называемые Суверенные территории Испании — испанские территории в континентальной Северной Африке на южном побережье Средиземного моря, на границе с Марокко;
2 автономных региона Португалии: Азорские острова и Мадейра;

2 группы островов, оспариваемые несколькими странами: Спратли и Парасельские острова;
Нейтральная территория Антарктика, статус которой определён по Договору об Антарктике, на часть территории имеется 8 территориальных притязаний семи государств Аргентинская Антарктика (Аргентина), Австралийская антарктическая территория (Австралия), Чилийская Антарктика (Чили), Земля Адели (Франция), Британская антарктическая территория (Великобритания), Территория Росса (Новая Зеландия), Земля королевы Мод и Остров Петра Первого (Норвегия);
Мальтийский орден — государствоподобное образование с особым статусом. Имеет статус наблюдателя при ООН. Имеет дипломатические отношения со 104 государствами. Иногда рассматривается как карликовое государство;
Азад Кашмир — особая территория под контролем Пакистана. Де-факто является частью Пакистана, официально признаётся Пакистаном в качестве самоуправляемого штата;
Сомалиленд — территория, в северной части африканского полуострова Сомали, являющееся фактически неконтролируемой центральным правительством, но не признанной ни какими-либо странами-членами ООН, ни частично признанными государствами;
Территории, не контролируемые центральным правительством (напр. Иракский Курдистан в Ираке, Ва и Шан в Мьянме, Вазиристан в Пакистане, Авдаленд, Азания, Галмудуг, Пунтленд и Хатумо в Сомали, Халистан в Индии);
Виртуальные государства. Например:
Княжество Себорга. По мнению властей Себорги, юридически их территория не является частью Италии. Конфликт между Себоргой и Италией является лишь декларативным, судебных или силовых столкновений между сторонами не было;
Силенд — самоуправляемая территория, провозглашённая суверенной в нейтральных водах, в настоящий момент считающаяся находящейся в суверенных морских водах Соединённого Королевства, но на которую при этом Соединённое Королевство не претендует. По мнению некоторых источников, Силенд отвечает всем критериям государственности, указанным в Конвенции Монтевидео о правах и обязанностях государств, и является непризнанным государством;
Королевство Таволара;
Молоссия;

Военные и военно-морские базы, находящиеся на территории других государств.

Названия стран приводятся на основе Общероссийского классификатора стран мира (ОКСМ).
Данный список стран отличается от списка, данного на английской странице. (Подробности см. Обсуждение).


== Список стран ==
 Абхазия — Республика Абхазия: государство, признанное шестью странами-членами ООН (Российской Федерацией, Никарагуа, Венесуэлой, Науру и Вануату), частично признанной Южной Осетией и двумя непризнанными государствами: НКР и ПМР; согласно конституции Грузии, входит в состав Грузии
Австралия Австралия — Австралийский Союз
Австрия Австрия — Австрийская Республика
Азербайджан Азербайджан — Азербайджанская Республика
Аландские острова Аландские острова — автономная территория Финляндии
Албания Албания — Республика Албания
Алжир Алжир — Алжирская Народная Демократическая Республика
Ангилья Ангилья — заморская территория Великобритании
Ангола Ангола — Республика Ангола
Андорра Андорра — Княжество Андорра
Антигуа и Барбуда Антигуа и Барбуда
Аргентина Аргентина — Аргентинская Республика
Армения Армения — Республика Армения
Аруба Аруба — самоуправляемое государство со значительной автономией в составе Королевства Нидерландов. До 1986 года: Нидерландские Антильские острова
Афганистан Афганистан — Исламская Республика Афганистан
 Багамские Острова — Содружество Багамских Островов. Альтернативное название: Багамы
Бангладеш Бангладеш — Народная Республика Бангладеш
Барбадос Барбадос
Бахрейн Бахрейн — Королевство Бахрейн
Белиз Белиз
Белоруссия Белоруссия — Республика Беларусь
Бельгия Бельгия — Королевство Бельгия
Бенин Бенин — Республика Бенин
 Бермудские Острова — заморская территория Великобритании. Альтернативное название: Бермуды
Болгария Болгария — Республика Болгария
Боливия Боливия — Многонациональное Государство Боливия
Бонэйр Бонэйр — особая община в составе Карибских Нидерландов. До 2010 года: Нидерландские Антильские острова
Босния и Герцеговина Босния и Герцеговина (БиГ) — Босния и Герцеговина: состоит из двух самоуправляющихся образований — Республики Сербской и Федерации Боснии и Герцеговины
Ботсвана Ботсвана — Республика Ботсвана
Бразилия Бразилия — Федеративная Республика Бразилия
Бруней Бруней — Государство Бруней-Даруссалам
Буркина-Фасо Буркина-Фасо. До 1984 года: Республика Верхняя Вольта
Бурунди Бурунди — Республика Бурунди
Бутан Бутан — Королевство Бутан
Вануату Вануату — Республика Вануату
Ватикан Ватикан — Государство-город Ватикан
Великобритания Великобритания — Соединённое Королевство Великобритании и Северной Ирландии
Венгрия Венгрия
Венесуэла Венесуэла — Боливарианская Республика Венесуэла
 Виргинские Острова (США) — Американские Виргинские острова: заморское владение (неприсоединённая территория) США. Альтернативное название: Виргины (Американские)
 Виргинские Острова (Великобритания) — Британские Виргинские Острова: заморская территория Великобритании. Альтернативное название: Виргины (Британские)
Восточный Тимор Восточный Тимор — Демократическая Республика Восточный Тимор
Вьетнам Вьетнам — Социалистическая Республика Вьетнам
Габон Габон — Габонская Республика
Гаити Гаити — Республика Гаити
Гайана Гайана — Кооперативная Республика Гайана
Гамбия Гамбия — Республика Гамбия
Гана Гана — Республика Гана
Гваделупа Гваделупа — заморский регион Франции
Гватемала Гватемала — Республика Гватемала
Гвиана Гвиана — Французская Гвиана: заморский регион Франции
Гвинея Гвинея — Гвинейская Республика
Гвинея-Бисау Гвинея-Бисау — Республика Гвинея-Бисау
Германия Германия — Федеративная Республика Германия
Гернси Гернси — коронная земля Великобритании
Гибралтар Гибралтар — заморская территория Великобритании
Гондурас Гондурас — Республика Гондурас
Гонконг Гонконг (Сянган) — Специальный административный район Гонконг Китайской Народной Республики: территория, управляемая Китаем на основе специального международного соглашения
Гренада Гренада
Гренландия Гренландия — зависимая территория (автономный регион) Дании
Греция Греция — Греческая Республика
Грузия Грузия
Гуам Гуам — заморское владение (неприсоединённая территория) США
Дания Дания — Королевство Дания
 Джерси — коронная земля Великобритании
Джибути Джибути — Республика Джибути
Доминика Доминика — Содружество Доминики
Доминиканская Республика Доминиканская Республика
ДНР ДНР — Донецкая Народная Республика: государство, признанное частично признанной Южной Осетией и непризнанной Луганской Народной Республикой; согласно конституции Украины, входит в её состав как Донецкая область
Египет Египет — Арабская Республика Египет
Замбия Замбия — Республика Замбия
Зимбабве Зимбабве — Республика Зимбабве
Израиль Израиль — Государство Израиль
Индия Индия — Республика Индия
Индонезия Индонезия — Республика Индонезия
Иордания Иордания — Иорданское Хашимитское Королевство
Ирак Ирак — Республика Ирак
Иран Иран — Исламская Республика Иран
Ирландия Ирландия
Исландия Исландия
Испания Испания — Королевство Испания
Италия Италия — Итальянская Республика
Йемен Йемен — Йеменская Республика
Кабо-Верде Кабо-Верде — Республика Кабо-Верде. До 1986 года: Республика Острова Зелёного Мыса
Казахстан Казахстан — Республика Казахстан
Острова Кайман Острова Кайман — заморская территория Великобритании. Альтернативное название: Кайманы
Камбоджа Камбоджа — Королевство Камбоджа. До 1989 года: Кампучия
Камерун Камерун — Республика Камерун
Канада Канада
Катар Катар — Государство Катар
Кения Кения — Республика Кения
Кипр Кипр — Республика Кипр
Северный Кипр Северный Кипр — частично признанное государство (признано Турцией); согласно конституции Кипра, входит в состав Кипра
Киргизия Киргизия — Киргизская Республика или Кыргызстан — Кыргызская Республика
Кирибати Кирибати — Республика Кирибати
 Китайская Народная Республика, не признается 23 государствами-членами ООН
Китайская Республика Китайская Республика — согласно конституции КНР, является провинцией КНР, признана 23 государствами как легитимное правительство всего Китая и до 25 октября 1971 года представляла Китай в ООН, включает Тайвань
Кокосовые острова Кокосовые острова — Территория Кокосовые (Килинг) Острова: внешняя территория Австралии
Колумбия Колумбия — Республика Колумбия
 Коморские Острова — Союз Коморских Островов. Альтернативное название: Коморы
 Демократическая Республика Конго. До 1997 года: Заир. Альтернативное название: ДРК и Конго (Киншаса)
Республика Конго Республика Конго. Альтернативное название: Конго (Браззавиль)
 Корейская Народно-Демократическая Республика. Альтернативное название: Северная Корея
Республика Корея Республика Корея. Альтернативное название: Южная Корея
Республика Косово Республика Косово — частично признанное государство, находившееся под протекторатом ООН и переходящее под протекторат Евросоюза, которое, согласно конституции Сербии, является Автономным краем Косово и Метохия в составе Сербии
Коста-Рика Коста-Рика — Республика Коста-Рика
Кот-д’Ивуар Кот-д’Ивуар — Республика Кот-д’Ивуар. До 1986 года: Берег Слоновой Кости
Куба Куба — Республика Куба
Кувейт Кувейт — Государство Кувейт
 Кука острова — самоуправляющееся государственное образование в свободной ассоциации с Новой Зеландией
Кюрасао Кюрасао — самоуправляемое государство со значительной автономией в составе Королевства Нидерландов. До 2010 года: Нидерландские Антильские острова
Лаос Лаос — Лаосская Народно-Демократическая Республика
Латвия Латвия — Латвийская Республика
Лесото Лесото — Королевство Лесото
Либерия Либерия — Республика Либерия
Ливан Ливан — Ливанская Республика
Ливия Ливия — Государство Ливия
Литва Литва — Литовская Республика
Лихтенштейн Лихтенштейн — Княжество Лихтенштейн
ЛНР ЛНР — Луганская Народная Республика: государство, признанное частично признанной Южной Осетией и непризнанной Донецкой Народной Республикой; согласно конституции Украины, входит в её состав как Луганская область
Люксембург Люксембург — Великое Герцогство Люксембург
Маврикий Маврикий — Республика Маврикий
Мавритания Мавритания — Исламская Республика Мавритания
Мадагаскар Мадагаскар — Республика Мадагаскар
Майотта Майотта — заморский регион Франции
 Макао (Аомынь) — Специальный административный район Аомынь Китайской Народной Республики: территория, управляемая Китаем на основе специального международного соглашения
Македония Македония — Республика Македония. Альтернативное название: Бывшая Югославская Республика Македония
Малави Малави — Республика Малави
Малайзия Малайзия 
Мали Мали — Республика Мали
Мальдивы Мальдивы — Мальдивская Республика
Мальта Мальта — Республика Мальта
Марокко Марокко — Королевство Марокко
Мартиника Мартиника — заморский регион Франции
Маршалловы Острова Маршалловы Острова — Республика Маршалловы Острова
Мексика Мексика — Мексиканские Соединённые Штаты
Микронезия Микронезия — Федеративные Штаты Микронезии
Мозамбик Мозамбик — Республика Мозамбик
Молдавия Молдавия — Республика Молдова
Монако Монако — Княжество Монако
Монголия Монголия
Монтсеррат Монтсеррат — заморская территория Великобритании
Мьянма Мьянма — Союз Мьянма. До 1989 года: Бирма
 Мэн — Остров Мэн: коронная земля Великобритании
Нагорно-Карабахская Республика Нагорно-Карабахская Республика — признана частично признанными Абхазией, Южной Осетией и непризнанной ПМР; согласно конституции Азербайджанской Республики, входит в состав Азербайджана
Намибия Намибия — Республика Намибия
Науру Науру — Республика Науру
Непал Непал — Федеративная Демократическая Республика Непал
Нигер Нигер — Республика Нигер
Нигерия Нигерия — Федеративная Республика Нигерия
Нидерланды Нидерланды — Королевство Нидерландов
Никарагуа Никарагуа — Республика Никарагуа
Ниуэ Ниуэ — самоуправляющееся государственное образование в свободной ассоциации с Новой Зеландией
Новая Зеландия Новая Зеландия
Новая Каледония Новая Каледония — заморское административно-территориальное образование с особым статусом Франции
Норвегия Норвегия — Королевство Норвегия
 Норфолк остров — внешняя территория Австралии
 Объединённые Арабские Эмираты
Оман Оман — Султанат Оман
Пакистан Пакистан — Исламская Республика Пакистан
Палау Палау — Республика Палау. Альтернативное название: Белау
 Государство Палестина, территория, частично оккупированная Израилем; включает Сектор Газа и Западный берег реки Иордан
Панама Панама — Республика Панама
Папуа — Новая Гвинея Папуа — Новая Гвинея — Независимое Государство Папуа — Новая Гвинея
Парагвай Парагвай — Республика Парагвай
Перу Перу — Республика Перу
 Питкэрн острова — заморская территория Великобритании
 Полинезия Французская — заморское сообщество Франции
Польша Польша — Республика Польша
Португалия Португалия — Португальская Республика
ПМР ПМР — Приднестровская Молдавская Республика, признана частично признанными Абхазией, Южной Осетией и непризнанной НКР; согласно конституции Молдавии, входит в её состав. Альтернативное название: Приднестровье
Пуэрто-Рико Пуэрто-Рико — Содружество Пуэрто-Рико: заморское владение (неприсоединённая территория) США
Реюньон Реюньон — заморский регион Франции
 Рождества остров — внешняя территория Австралии
Россия Россия — Российская Федерация
Руанда Руанда — Республика Руанда
Румыния Румыния
Саба Саба — особая община в составе Карибских Нидерландов. До 2010 года: Нидерландские Антильские острова
Сальвадор Сальвадор — Республика Эль-Сальвадор
Самоа Самоа — Независимое Государство Самоа. До 1997 года: Западное Самоа
 Самоа Американское — заморское владение (неприсоединённая территория) США. Альтернативное название: Восточное Самоа
Сан-Марино Сан-Марино — Республика Сан-Марино
Сан-Томе и Принсипи Сан-Томе и Принсипи — Демократическая Республика Сан-Томе и Принсипи
Саудовская Аравия Саудовская Аравия — Королевство Саудовская Аравия
Сахарская Арабская Демократическая Республика Сахарская Арабская Демократическая Республика — большая часть территории оккупирована и интегрирована в Марокко. Альтернативное название