Doña Bárbara (no Brasil, Dona Bárbara) é uma telenovela colombo-estadunidense que foi produzida pela Telemundo em parceria com a Sony Pictures e exibida de 4 de agosto de 2008 a 22 de maio de 2009 em 191 capítulos.
Foi exibida no Brasil em horário nobre pela CNT de 2 de maio a 30 de dezembro de 2011, substituindo Acorralada e antecedendo El sexo débil.


== Elenco ==
Edith González - Doña Bárbara Guaimarán
Christian Meier - Santos Luzardo
Génesis Rodríguez - Marisela Barquero/Bárbara Guaimarán (jovem)
Juan Pablo Shuk - Gonzalo Zuluaga
Maritza Rodríguez - Asunción Vergel De Luzardo
Javier Alexander - César Barquero
Paula Barreto - Luisana Requena
Luis Mesa - José Luzardo
Jencarlos Canela - Asdrúbal
Helmer Valenzuela - Lorenzo Barquero (jovem)
Katie Barberi - Cecilia Vergel
Arap Bethke - Antonio Sandoval
Paulo Quevedo - Balbino Paiba
Roberto Mateos - Lorenzo Barquero
Raúl Gutiérrez - Coronel Diógenes Pernalete
Lucy Martínez - Eustaquia
Iván Rodríguez - Melesio Sandoval
Martha Isabel Bolaños - Josefa
Alberto Valdiri - Mujiquita
Amparo Moreno - Casilda
Daniela Tapia - Gervasia
Lucho Velasco - Melquiades "El Brujeador"
Mimi Morales - Altagracia
Alejandra Sandoval - Genoveva
Pedro Rendón - Carmelito
Roberto Manrique - Maria Nieves
Tiberio Cruz - Juan Palacios "Pajarote"
Andrés Ogilvie-Browne - Juan Primito
Bibiana Corrales - Melezia
Adriana Silva - Josefina
Gary Forero - León Mondragón
Andrés Martínez - Tigre Mondragón
Naren Daryanani - Onza Mondragón
Jimmie Bernal - William Danger
Esmeralda Pinzón - Federica Pernalete
Hebert King - Don Encarnación Matute
Humberto Arango - Humberto Chávez / Fidel Castell / El Sapo
Hernán Méndez - Perro de agua
Hermes Camelo - El Chepo
Julio Pachón - Nicolás Meléndez
Harry Geitner - Julián Barreto
Gabriel González - Baltazar Arias, doctor
Guillermo Villa - Padre Perni