यह विश्व के देशों की सूची, एक सिंहावलोकन कराती है, विश्व के राष्ट्रों का, जो कि देवनागरी वर्णक्रमानुसार व्यवस्थित है। इसमें स्वतंत्र राज्य भी सम्मिलित हैं। (जो कि अन्तराष्ट्रीय मान्यताप्राप्त हैं और जो अमान्यता प्राप्त), हैं, बसे हुए हैंपरतंत्र क्षेत्र, एवं खास शासकों के क्षेत्र भी।
ऐसे समावेश मानदण्ड अनुसार यह सूची शब्द `देश' एवं `सार्वभौम राष्ट्र' को पर्यायवाची नहीं मानती। जैसा कि प्रायः साधारण बोलचाल में प्रयोग किया जाता है। कृप्या ध्यान रखें कि किन्हीं खास परिस्थितिवश एवं किन्हीं खास भाषाओं में 'देश' शब्द को सर्वथा प्रतिबंधात्मक अर्थ समझा जाता है। अतः केवल 193 निम्नलिखित प्रविष्टियाँ ही प्रथम शब्द (देश या राष्ट्र) में समझे जाएं।
यह सूची दिए गए देशों के क्षेत्राधिकार में आने वाले सभी क्षेत्रों को आवृत्त करती है, अर्थात क्षेत्र, जलीय क्षेत्र (जिसमें जलीय आंतरिक क्षेत्र एवं थल से लगे जलीय क्षेत्र भी आते हैं), विशिष्ट आर्थिक क्षेत्र, कॉण्टीनेण्टल शैल्फ, एवं हवाई क्षेत्र.
सूची में दिए गए देशों के नाम हिन्दी में हैं, साथ ही हिंदी में पूर्ण राजकीय नाम के प्रामाणिक या लघु नाम भी हैं (उदाहरणतः अफ्गानिस्तान प्रयोग किया गया है अफ्गानिस्तान इस्लामी गणराज्य हेतु। किसी भी नाम, जो कि सूची में दिया गया है; किसी नामकरण संबंधी विवाद में संदर्भ हेतु प्रयोगार्थ नही हैं।


== विषय वस्तु सूची: ==


== सम्मिलित राजनैतिक सत्ताओं के प्रकार ==
इस सूची में 245 प्रकार की सत्ताएं निम्न हैं :
193 राज्य जिन्हे अन्तराष्ट्रीय मान्यता प्राप्त है।
192 संयुक्त राष्ट्र संघ के सदस्य।
1 राज्य जेसे अन्तराष्ट्रीय मान्यता प्राप्त है, किन्तु संयुक्त राष्ट्र संघ का सदस्य नहीं है, जिस पर होली सी (a संयुक्त राष्ट्र समान्य सभा प्रेक्षक या स्थायी सदस्य): वैटिकन शहर का शासन है।

8 वे राज्य जिन्हेः सामान्य मान्यता नहीं मिली है, वे संयुक्त राष्ट्र संघ के सदस्य भी नहीं हैं, जिन्हें अन्तराष्ट्रीय कानून के अन्तर्गत समझा जाता है, वे माण्ट्वीडियो सम्मेलन के उत्तराधिकारी राज्य कहला सकते हैं।
1 राष्ट्र जो सं रा संघ का सदस्य नहीं है, चीन, जिसे 23 UN सदस्य राज्यों एवं होली सी (वैटिकन शहर) से मान्यता प्राप्त है, तथा वर्तमान में डी फैक्टो अन्तराष्ट्रीय सम्बन्धों के अन्तर्गत आता है, यानि चीन गणराज्य (प्रायः ताईवान कहा जाता है)।
1 राज्य, जो कि अफ्रीकी संघ और एशियाई - अफ्रीकी नैतिक भागीदारी जो कि 2005 एशियाई-अफ्रीकी सम्मेलन में निर्मित हुई थी, का सदस्य है।
1 डी फैक्टो स्वतंत्र राज्य, राजनयिक तौर पर किसी संयुक्त राष्ट्र संघ सदस्य द्वारा मान्यता प्राप्त नहीं है, सिवाय तुर्की के उत्तरी साईप्रस का तुर्की गणराज्य.उत्तरी सायप्रस ही वह राज्य है सायप्रस के अधिकार क्षेत्र के अधीन।
5 डी फैक्टो (वास्तविक) स्वतंत्र राज्य, अबखाजिया (जॉर्जिया (देश)), नागोर्नो-काराबाख (अज़रबैजान), ट्राँस्निस्ट्रिया (मॉल्दोवा), सोमालीलैंड (सोमालिया), and दक्षिण ओस्सेटिया (जॉर्जिया (देश)), किसी सं राष्ट्र सदस्य से कभी मान्यता प्राप्त नहीं हैं।

38 बसे हुए क्षेत्र परतंत्र क्षेत्र:
3 ऑस्ट्रेलियाई राज्य (क्रिस्मस द्वीप, कोकोज (कीलिंग) द्वीप समूह and नॉर्फ्लोक द्वीप).
2 सुदूर देश डेनमार्क (फैरो द्वीप समूह एवं ग्रीनलैंड).
7 फ्रांसीसी सुदूर क्षेत्र1 सुई जनेरिस (अपूर्व) समुदाय (न्यू कैलेडोनिया).
6 सुदूर कलेक्टिविटियाँ:
1 सुदूर देश (फ्रैंच पॉलीनेशिया )
1 विभागीय कलेक्टिविटि (मायोट्ट्)
1 देशीय कलेक्टिविटि (सेंट पियरे एवं मि॑उइलोन)
2 कलेक्टिविटि (सेंट बार्थेलेमी and सेंट मार्टिन)
1 क्षेत्र (वैलिस एवं फिच्यूना )

2 सुदूर देश नीदरलैण्ड राज्य (अरूबा and नीदरलैण्द ऍण्टिल्ल्स्).
3 परतंत्र क्षेत्र न्यूजीलैण्ड:के अन्तर्गत।
2 राज्य मुक्त संघ में न्यूजीलैण्ड (कुक द्वीप समूह तथा निउए).
1 सागरपार क्षेत्र (टोकेलाउ).

16 ब्रिटिश क्षेत्र
13 ब्रिटिश सुदूर क्षेत्र ब्रिटेन या यूनाइटेड किंगडम के, (अंगिल्ला, बरमूडा, ब्रिटिश वर्जिन द्वीप, केय्मैन द्वीप , फॉकलैण्ड , जिब्राल्टर , माँटसेराट, पिटकैर्न द्वीप, सेंट हेलेना (एवं उनकी परतंत्रताएं असेंशियन द्वीप एवं ट्रिस्टान दा कुन्हा ), तुर्क एवं कोकोस द्वीप, साथ ही सार्वभौम मूल क्षेत्र of अक्रोत्तिरी एवं धेकेलिया ).
3 क्राउन डिपेंडेंसी (गुएर्न्से , जर्सी and the आइल ऑफ मान).

5 संयुक्त राजशाही के असम्मिलित क्षेत्र :
2 राष्ट्रमंडल क्षेत्र (उत्तरी मैरियाना द्वीप and प्युर्तोरिको ).
2 संगठित क्षेत्र (गुयाम एवं संयुक्त राज्य वर्जिन द्वीप ).
1 डी फैक्टो संगठित क्षेत्र ऑर्गैनिक ऍक्ट रहित (अमेरिकी सामोआ).

6 विशिष्ट एन्टिटियों की सूची जिन्हें अन्तरराष्ट्रीय समझौते द्वारा मान्यता प्राप्त हैं (ऑलैंड जो कि फिनलैंड में है, स्वालबार्ड जो कि नॉर्वे में है, कोसोवो सर्बिया में, फिलिस्तीन और साथ ही 2 विशिष्ट प्रशासनिक क्षेत्र चीन में - हाँगकाँग एवं मकाउ).
विश्व के देशओं की सूची के अनुलग्नक, में एक रूपरेखा दी गई है, उन प्रविष्टियों की जो इसमें शामिल नहीं किए गए हैं। इसमें सुभिन्न राजनैतिक एवं वैधिक सत्तएं आती हैं, जो कि देश हैं परंतु एक सार्वभौम राष्ट्र के समूचे भाग माने जाते हैं, खासकर यूनाइटेड किंग्डम एवं जर्मनी के अन्तर्गत आने वाले देश।


== राष्ट्र नामों की कुंजी ==
बैहरीन (बोल्ड या मोटा) - राष्ट्र, जिन्हें अन्तराष्ट्रीय मान्यता प्राप्त है।
अबखाजिया (मोटा एवं झुका - बोल्ड एवं इटैलियाई) - राष्ट्र जिन्हें अन्तराष्ट्रीय मान्यता प्राप्त नहीं है।
केयमैन द्वीप समूह (साधारण) - अन्य अ-राज्य देश


== राष्ट्रों की सूची ==


=== अ ===
 अक्रोत्तिरी एवं धेकेलिया – अक्रोत्तिरी एवं धेकेलिया के सार्वभौम बेस क्षेत्र (UK सुदूर क्षेत्र)
 अबखाजिया – अबखाजिया गणराज्य
 अंगिल्ला (UK overseas territory) -- अंगिल्ला
 असेंशियन द्वीप ( UK सुदूर क्षेत्र सेंट हेलेना की परतंत्रता )
 अंगोला – अंगोला गणराज्य
 अंडोरा – अन्डोरा रियासत
 अजरबैजान – अजरबैजान गणराज्य
 अफगानिस्तान – अफगानिस्तान इस्लामी गणराज्य
 अमेरिकी सामोआ – अमेरिकी सामोआ प्रदेश (US क्षेत्र)
 अरूबा -- अरूबा (स्वयं शासित प्रदेश नीदरलैण्ड राज्य में)
 अर्जेंटीना – अर्जेण्टीना गणराज्य
 अल्जीरिया – अल्जीरिया प्रजातांत्रिक गणराज्य
 अल्बानिया – अल्बानिया गणराज्य


=== आ ===
 आइल ऑफ मान (ब्रिटिश क्राउन परतंत्रता)
 आइसलैंड – आइसलैंड गणराज्य
 आयरलैंड - आयरलैंड गणराज्य
"आइवरी कोस्ट" हेतु, देखें कोटे ड आइवोरे
 आर्मेनिया – आर्मेनिया गणराज्य


=== इ ===
 इंडोनेशिया – इंडोनेशिया गणराज्य
 इक्वेडोर – इक्वेडोर गणराज्य
 इज़रायल – इज्राइल राष्ट्र
 इटली – इतालवी गणराज्य या इटली
 इथियोपिया – इथियोपिया संघीय जनताँत्रिक गणराज्य
 इराक – इराक गणराज्य


=== ई ===
 ईक्वीटोरियल गीनिया – ईक्वीटोरियल गीनिया गणराज्य
 ईरान – ईरान इस्लामी गणराज्य
 ईरीट्रिया – ईरीट्रिया राज्य


=== उ ===
 उज्बेकिस्तान – Republic of Uzbekistan
 उत्तर कोरिया – उत्तर कोरिया जनतांत्रिक गणराज्य
 उत्तरी साईप्रस – उत्तरी साईप्रस तुर्की गणराज्य


=== ए ===
 एन्टीगुआ एवं बारबुदा
 एल सेल्वडॉर – एल सेल्वडॉर गणराज्य
 एस्तोनिया – एस्तोनिया गणराज्य


=== ऑ ===
 ऑलैण्ड – ऑलैण्ड द्वीप (फिनलैण्ड का स्वायत्त प्रांत)
 ऑस्ट्रिया – ऑस्ट्रिया गणराज्य
 ऑस्ट्रेलिया – ऑस्ट्रेलिया का राष्ट्रमण्डल


=== ओ ===
 ओमान – ओमान सल्तनत


=== क ===
 कज़ाकिस्तान – कज़ाकिस्तान गणराज्य
 कतर – कतर राजत्व
 कनाडा
 कम्बोडिया – कम्बोडिया राज्य
 कांगो – कांगो जनताँत्रिक गणराज्य
 किर्घिस्तान – किर्घिस्तान गणराज्य
 कीरीबाती – कीरीबाती
 कुक द्वीपसमूह - कुक द्वीपसमूह (न्यूजीलैंड का क्षेत्र)
 कुवैत – कुवैत राज्य
 केन्द्रीय अफ्रीकी गणराज्य
 केन्या – केन्या गणराज्य
 केप वर्दे – केप वर्दे गणराज्य
 केय्मैन द्वीप (UK सुदूर क्षेत्र)
 कैमरून – कैमरून गणराज्य
 कॉन्गो – कॉन्गो गणराज्य
 कोकोज (कीलिंग) द्वीप समूह – कोकोज (कीलिंग) द्वीप समूह (Australian overseas territory)
 कोत द'ईवोआर – कोटे ड आइवोरे गणराज्य
 कोमोरोज – कोमोरोज संघ
 कोलोंबिया – कोलोंबिया गणराज्य
 कोसोवो
 कोस्टा रीका – कोस्टा रीका
 क्यूबा – क्यूबा गणराज्य
 क्रिस्मस द्वीप – क्रिस्मस द्वीप (ऊस्ट्रेलियाई सुदूर क्षेत्र)
 क्रोएशिया – क्रोएशिया गणराज्य


=== ग ===
 गीनिया – गीनिया गणराज्य
 गीनिया-बिसाउ – गीनिया-बिसाउ गणराज्य
 गुएर्न्से – गुएर्न्से का बैलिविक (ब्रिटिश क्राउन परतंत्रता)
 गुयाना – गुयाना सहकारी गणराज्य
 गुयाम – गुयाम क्षेत्र (US संगठित क्षेत्र)
 गैबॉन – गैबॉन गणराज्य
 गैम्बिया – गैम्बिया गणराज्य
 ग्रीनलैंड -- ग्रीनलैंड(डेनमार्क राजत्व में स्वयं शासित राष्ट्र )
 ग्रीस – हैलेनिक गणराज्य (यूनान या ग्रीस)
 ग्रेनेडा -- ग्रेनेडा
 ग्वाटेमाला – ग्वाटेमाला गणराज्य


=== घ ===
 घाना – घाना गणराज्य


=== च ===
 चिली – चिली गणराज्य
 चीन – चीन जनताँत्रिक गणराज्य
"चीन गणराज्य" हेतु, देखें ताइवान
 चेक रिपब्लिक - चेक गणराज्य
 चैड – चैड गणराज्य


=== ज ===
 जमैका -- जमैका
 जर्मनी – जर्मनी संघीय गणराज्य
 जर्सी – बैलिविक ऑफ जर्सी (ब्रिटिश क्राउन परतंत्रता")
 जापान -- जापान
 जाम्बिया – जांबिया गणराज्य
 जार्डन – जार्डन जॉर्डन का हाशेमिते राजत्व
 जिब्राल्टर -- जिब्राल्टर (UK सुदूर क्षेत्र)
 ज़िम्बाब्वे – जिम्बाब्वे गणराज्य
 जॉर्जिया (देश) -- जॉर्जिया


=== ट ===
 टुवालु
 टोंगा – टोंगा राजत्व
 टोकेलाउ (न्यूजीलैंड का सुदूर क्षेत्र)
 टोगो – टोगोलीज़ गणराज्य
 ट्यूनीशिया – ट्यूनीशिया गणराज्य
 ट्राँस्निस्ट्रिया - ट्राँस्निस्ट्रिया मॉल्दोवन ट्राँस्निस्ट्रिया
 ट्रिस्टान दा कुन्हा (Dependency of the UK overseas territory of Saint Helena)


=== ड ===
 डेनमार्क – डेनमार्क राज्य
 डोमिनिकन गणराज्य- डोमिनिकन गणराज्य
 डोमिनिका – डोमिनिका गणराज्य


=== त ===
 तंजानिया – तंजानिया संयुक्त गणराज्य
 ताईवान – चीन गणराज्य
 ताजिकिस्तान – ताजिकिस्तान गणराज्य
For "तिमोर-लेस्त ", see पूर्वी तिमोर
 तुर्क एवं कोकोस द्वीप (UK सुदूर क्षेत्र)
 तुर्कमेनिस्तान
 तुर्की – तुर्की गणराज्य
 त्रिनिदाद एवं टोबेगो – त्रिनिदाद एवं टोबेगो गणराज्य


=== थ ===
 थाईलैंड – थाईलैंड गणराज्य
 दक्षिण अफ्रीका – दक्षिण अफ्रीका गणराज्य


=== द ===
 दक्षिण ओस्सेटिया – दक्षिण ओस्सेटिया गणराज्य
 दक्षिण कोरिया – दक्षिण कोरिया गणराज्य
 दक्षिण सूडान – दक्षिणी सूडान गणतंत्र
 द्जीबाउती – द्जीबाउती गणराज्य


=== ध ===
For "धेकेलिया", - धेकेलिया, देखें Akrotiri and Dhekelia
 नाइगर – नाईगर गणराज्य


=== न ===
 नाईजीरिया – नाईजीरिया संघीय गणराज्य
 नाउरु – नाउरु गणराज्य
 नागोर्नो-काराबाख – नागोर्नो-काराबाख नागोर्नो-काराबाख
 नामीबिया – नामीबिया गणराज्य
 निकारागुआ – निकारागुआ नागोर्नो-काराबाख
 नीदरलैंड – नीदरलैंड राजत्व
 नीदरलैंड एण्टिल्स (नीदरलैंड राजत्व का स्वयं शासित क्षेत्र)
 नीयुए (न्यूजीलैंड का क्षेत्र)
 नेपाल – नेपाल
 नॉर्फोक द्वीप – नोर्फोक द्वीप समूह का क्षेत्र (ऑस्ट्रेलियाई सुदूर क्षेत्र)
 नॉर्वे – नॉर्वे राज्य
 न्यू कैलेडोनिया –
 न्यूज़ीलैंड


=== प ===
 पनामा – पनामा गणराज्य
 पश्चिमी सहारा
 पाकिस्तान – पाकिस्तान इस्लामी गणराज्य
 पापुआ न्यू गीनिया – पापुआ न्यू गीनिया स्वतंत्र राज्य
 पालाउ – पालाउ गणराज्य
 पिटकैर्न द्वीप – पिटकैर्न, हैंडरसन, ड्यूसी, एवं ओएनों द्वीप समूह (UK overseas territory)
"पीपल्स रिपब्लिक ऑफ चाइना " हेतु, देखेंचीन
 पुर्तगाल – पुर्तगाली गणराज्य
 पूर्वी तिमोर – पूर्वी तिमोर या टिमोर- लेस्त जनताँत्रिक गणराज्य
 पॅरेगुवे – पॅरेगुवे गणराज्य
 पेरु – पेरु गणराज्य
 पॉलीनेशिया -- फ्रैंच पॉलीनेशिया (फ्रांसीसी सुदूर कलेक्टिविटी)
 पोलैंड – पोलैंड गणराज्य
 प्युर्तोरिको – प्युर्तोरिको राष्ट्रमण्डल (US राष्ट्रमण्डल )
"प्रिद्नेस्त्रोवि" हेतु, देखें ट्राँस्निस्ट्रिया


=== फ ===
 फिनलैंड – फिनलैंड गणराज्य
 फिलिस्तीन – Occupied फिलिस्तीनी क्षेत्र
 फिलीपींस – फिलीपींस गणराज्य
 फीजी – फीजी द्वीप समूह गणराज्य
 फैरो -- फैरो द्वीप समूह (Self-governing country in the Kingdom of Denmark)
 फॉकलैण्ड -- फॉकलैण्ड द्वीपसमूह (UK overseas territory)
 फ़्राँस – फ्रांस या फ्राँसीसी गणराज्य


=== ब ===
बर्मा हेतु", देखेंम्याँमार - म्याँमार
 बरण्डी – बरण्डी गणराज्य
 बरमूडा - बरमूडा (UK overseas territory)
 बर्कीना फासो - बर्किना फासो
 बल्गारिया – बल्गारिया गणराज्य
 बहरीन – बहरैन राजत्व
 बहामास – बहामास राष्ट्रमण्डल
 बांग्लादेश – बांग्लादेश जनतांत्रिक गणराज्य
 बार्बादोस - बार्बैडॉस
 बेनिन – बेनिन गणराज्य
 बेलीज़ - बेलीज़
 बेलारूस – बेलारूस गणराज्य
 बेल्जियम – बेल्जियम राजत्व
 बोत्स्वाना – बोत्स्वाना गणराज्य
 बोलीविया – बोलीविया गणराज्य
 बौसनिया एण्ड हेर्ज़ेगोविना - बौसनिया एण्ड हेर्ज़ेगोविनाराज्य संघ
 ब्राज़ील – ब्राज़ील माण्डलिक गणराज्य
 ब्रिटिश वर्जिन द्वीप – ब्रिटिश वर्जिन द्वीप (UK सुदूर क्षेत्र )
 ब्रूनेई – नेगारा ब्रूनेई दारुस्सलाम


=== भ ===
 भारत – भारत गणराज्य
 भूटान – भूटान राजत्व


=== म ===
 मंगोलिया
 मकाउ – मकाउ Macao Special Administrative Region of the People's Republic of China (Area of special sovereignty)
 मलेशिया -- मलेशिया संघ
 माँटसेराट (UK सुदूर क्षेत)
 माँटेनीग्रो – Republic of Montenegro
 माइक्रोनेशिया – Federated States of Micronesia
 माडागास्कार – माडागास्कार गण्आराज्य
 मायोट्ट – Departmental Collectivity of Mayotte (French सुदूर collectivity)
 मार्शल द्वीप – मार्शल द्वीप गणराज्य
 मालदीव – मालदीव गणराज्य
 मालावी – मालावी गणराज्य
 माली – माली गणराज्य
 माल्टा – माल्टा गणराज्य
 मिस्र – मिस्र अरब गणराज्य
 मेक्सिको – United Mexican States
 मैसेडोनिया – मैसेडोनिया गणराज्य
 उत्तरी मैरियाना द्वीप – उत्तरी मैरियाना द्वीप समूह का राष्ट्रमण्डल (US राष्ट्रमंडल)
 मॉरिशस – मॉरिशस गणराज्य
 मॉल्दोवा – Republic of Moldova
 मोजा़म्बीक – Republic of Mozambique
 मोनाको – Principality of Monaco
 मोरोक्को – Kingdom of Morocco
 मौरिशियाना – मौरिशियाना इस्लामी गणराज्य
 म्याँमार – Union of Myanmar
देल्हि


=== य ===
 यमन – यमन गणराज्य
 युगांडा – Republic of Uganda
 यूक्रेन
 यूरूगुए – यूरूगुए पूर्वी गणराज्