Sırpça (Sırp Kiril: српски, Latin: srpski) Slav dillerinin güney grubundan, Sırpların konuştuğu dil. Hırvatça ile birlikte "Sırp-Hırvat dili" olarak da bilinir. Sırpça, Sırbistan'ın resmî dilidir. Ayrıca Bosna-Hersek'in resmî dillerinden biridir. Çoğu Sırbistan, Karadağ, Bosna-Hersek ve Hırvatistan'da yaşayan 10 milyon Sırp tarafından konuşulur.19. yüzyılda Kiril alfabesi Sırpçaya uygulanırken, her ses için bir harf oluşturulmuştur ve bu yüzden (Türkçe için de dendiği gibi) Sırpça yazıldığı gibi okunan ve okunduğu gibi yazılan bir dildir.
Sırpçanın ilginç bir özelliği, hem Latin alfabesi hem de Kiril alfabesi kullanılarak yazılmasıdır. Bunun sebebi tarihseldir. Yugoslavya SFC yönetimi Sosyalist rejim nedeniyle Kiril alfabesini tercih etmiş; ancak ondan önceki Sırp-Hırvat federasyonunda kullanılan Latin alfabesinin kullanımı devam etmiştir.
Sırpçada Türkçeden gelme 8965 sözcük bulunmaktadır. Aşağıda bu kelimelerden bazılarını görebilirsiniz.


== Sırp AlfabesiDeğiştir ==

А а Б б В в Г г Д д Ђ ђ Е е Ж ж З з И и Ј ј К к Л л Љ  љ  М м
A a B b V v G g D d Đ đ E e Ž ž Z z I i J j K k L l Lj lj M m

Н н Њ  њ  О о П п Р р С с Т т Ћ ћ У у Ф ф Х х Ц ц Ч ч Џ  џ  Ш ш
N n Nj Nj O o P p R r S s T t Ć ć U u F f H h C c Č č Dž dž Š š


=== Sırpça kelime ve cümle kalıplarıDeğiştir ===
Zdravo: Merhaba.
Kako si: Nasılsın ?
Kako ste: Nasılsınız ?
Dobro sam: İyiyim.
Hvala: Teşekkür ederim.
Hvala lepo: Çok teşekkür ederim.
Vidimo se: Sonra görüşürüz.
Drago mi je: Memnun oldum.
Molim vas: Lütfen , rica etmek.
Volim te: Seni seviyorum.
Dobro došli: Hoş geldiniz.
Do viđenja: Hoşçakal
Dobar dan: İyi günler.
Dobro jutro: Günaydın
Dobro veče: İyi Akşamlar.
Laku noć: İyi geceler.
Ne razumem: Anlamıyorum.
Ne razumem te: Seni anlamıyorum
Ko ste vi?: Kimsiniz?
Ko ti si?: Kimsin?
Razumete li Srpski: Sırpça anlıyor musunuz?
Da li govoriš Srpski: Sırpça konuşuyor musun?
Razumem Srpski: Sırpça anlıyorum.
Govorim Srpski: Sırpça konuşuyorum.
Učim Srpski: Sırpça öğreniyorum.
Volim jabuku: Elmayı severim.
Od kojijaste: Kimlerdensiniz?
Kako se zovete: Adınız nedir?
Zovem se . . .: Adım. . .
Iz Turske: Türkiye'den
Izvinite: Affedersiniz.
Kako je vreme: Hava nasıl?
Da: Evet
Ne: Hayır
Gde: Nerede?
Šta radite: Ne yapıyorsunuz?
Jeste li vi Englez: İngiliz misiniz?
Jeste li vi gladni?: Aç mısınız?
Jesam: olumlu (ben)
Nisam: olumsuz (ben)
Šta: Ne
Zašto?: Niçin?
Nemoguće: İmkansız
Ne razumem Srpski: Sırpça anlayamam
Ne govorim Srpski: Sırpça konuşamam
Učenik: Ögrenci
Advokat: Avukat
Imate li rezervacije: Rezervasyonunuz var mı?
Imam . . . godina: Ben . . . yaşındayım
Da li si dobro: İyi misin?
Majka: Anne
Tata: B