Trappe van vergelyking is vorme van byvoeglike naamwoorde of bywoorde. 'n Byvoeglike naamwoord in Afrikaans kan drie vorme aanneem om die sterkte van die naamwoord aan te dui. As voorbeeld kan 'n voorwerp as groot, nog groter (meer as net groot) of as die heel grootste beskryf word. Soortgelyk kan 'n partytjie as lekker, nog lekkerder of as die heel lekkerste beskryf word.
Die middelste trap word die vergrotende trap genoem en die laaste trap die oortreffende trap. Die eerste trap is die basis woord. Die vergrotende (tweede) trap is gewoonlik die basis woord + die agtervoegsel 'er'. Die oortreffende (derde) trap is gewoonlik die basis woord + 'ste'.


== Voorbeelde ==


=== Afrikaans ===


==== Een klinker ====
dik - dikker - dikste
dun - dunner - dunste
vet - vetter - vetste


==== Een klinker + g ====
sag - sagter - sagste
lig - ligter - ligste
matig - matiger - matigste
pragtig - pragtiger - pragtigste
sleg - slegter - slegste
salig - saliger - saligste


==== Meer as een klinker ====
skoon - skoner - skoonste
laat - later - laatste 
geel - geler - geelste


==== Dubbele klinkers + g ====
laag - laer - laagste
leeg - leër - leegste
hoog - hoër - hoogste
droog - droër - droogste
moeg - moeër - moegste
vroeg - vroeër - vroegste


==== Dubbele klinkers of konsonante ====
vuil - vuiler - vuilste
koel - koeler - koelste


==== Dubbele klinkers + d ====
koud - kouer - koudste
breed - breër - breedste
oud - ouer - oudste


==== Woorde wat op 'n 'r' eindig ====
bitter - bitterder - bitterste
dapper - dapperder - dapperste
donker - donkerder - donkerste
lekker - lekkerder - lekkerste
swaar - swaarder - swaarste
ver - verder - verste


==== Woorde wat op 'n 's' eindig ====
los - losser - losste
boos - boser - boosste
fluks - flukser - fluksste
skaars - skaarser - skaarsste
snaaks - snaakser - snaaksste
vars - varser - varsste
woes - woester - woesste 


==== Een klinker + 'f' ====
dof - dowwer - dofste
grof - growwer - grofste
laf - lawwer - lafste
muf - muwwer - mufste


==== Een klinker + 'nk' ====
lank - langer - langste
jonk - jonger - jongste


==== Dubbele klinker + 'f' ====
doof - dower - doofste
braaf - brawer - braafste
gaaf - gawer - gaafste
lief - liewer - liefste


==== Uitsonderings ====
afgeleë - meer afgeleë - afgeleënste
bek-af - meer bek-af - bek-afste
baie - meer - meeste
bietjie - minder - minste
dood - dood - dood 
goed - beter - beste (botter?)
graag - liewer - graagste
ideaal - meer ideaal - ideaalste
kwaad - kwaaier - kwaadste
kwaad - kwater - kwaadste
na/naby - nader - naaste
nuut - nuwer - nuutste
pootuit - meer pootuit - pootuitste
ru - ruwer - ruuste
sku - skuwer - skuuste
slu - sluwer - sluuste
veel - meer - meeste
vrek - vrek - vrek 
vroeg - 