《해리 포터와 불의 잔》(Harry Potter and the Goblet of Fire)은 2005년 J. K. 롤링의 동명 소설을 원작으로 하여 만든, 영국과 미국 합작, 판타지 영화이다. 8부작 중 네 번째에 해당하는 작품이며, 마이클 뉴웰이 감독을 맡았다.


== 출연진편집 ==
해리 포터: 다니엘 래드클리프
론 위즐리: 루퍼트 그린트
헤르미온느 그레인저: 엠마 왓슨
프레드 위즐리: 제임스 펠프스
조지 위즐리: 올리버 펠프스
지니 위즐리: 보니 라이트
드레이코 말포이: 톰 펠튼
루시우스 말포이: 제이슨 아이삭스
네빌 롱바텀: 매튜 루이스
알버스 덤블도어: 마이클 갬본
루베우스 해그리드: 로비 콜트레인
미네르바 맥고나걸: 매기 스미스
세베루스 스네이프: 앨런 리크먼


== SBS 성우진(극장판과 동일)편집 ==
류덕환 - 해리 포터(다니엘 래드클리프)
김성은 - 론 위즐리(루퍼트 그린트)
이선영 - 헤르미온느 그레인저(엠마 왓슨)
장승길 - 알버스 덤블도어(마이클 갬본)
송준석 - 볼드모트(레이프 파인스)
노민 - 앨러스터 무디(브렌던 글리슨)
오인성 - 에이머스 디고리(제프 롤)
양석정 - 케드릭 디고리(로버트 패틴슨)
윤병화 - 루시우스 말포이(제이슨 아이삭스)
최흘 - 코넬리우스 퍼지(로버트 하디)
김태훈 - 바티 크라우치(로저 로이드 팩)
유해무 - 루베우스 해그리드(로비 콜트레인)
임수아 - 미네르바 맥고나걸(매기 스미스)
박지훈 - 세베루스 스네이프(앨런 리크먼)
안경진 - 리타 스키터(미란다 리처드슨)
강구한 - 시리우스 블랙(게리 올드만)
김준 - 아구스 필치(데이비드 브래들리)
여민정 - 초 챙(케이티 렁) / 패르바티 패틸(셰펄리 초두리)
신용우 - 빅터 크룸(스타니슬라프 야네프스키)
정혜옥 - 플뢰르 델라쿠르(클레망스 포에지)
시영준 - 이고르 카르카로프(프레드래그 베랙)
김장 - 조지 위즐리(올리버 펠프스) / 프레드 위즐리(제임스 펠프스)
정옥주
박경혜
김기