Lingua Turcica (Türkçe), notissima illa e familia Turcica et superfamilia Altaica, locutores habet circiter 70 000 000. Ea est lingua agglutinativa.
Kalendis Novembribus anno 1928 abecedarium Latinum in Turcia inducitur. Antea litterae Arabicae in usu erant.


== Situs ==
Lingua Turcica in Turcia, Cypro, re publica Macedonia, Syria, Mesopotamia, Libanus, Bulgaria, Persia, Agro Merulensique officialiter, etiam in Germania, Bulgaria, Graecia privatim adhibetur, et passim ubi gens Turcorum pervenit aut bello aut migrationibus.


== Microlexicon ==
salve - Merhaba!
gratias – sağolun/teşekkürler/çok teşekkürler/teşekkür ederim/sağol.
gratias multas – çok sağolun/teşekkür ederim.
valete – görüşmek üzere/Hoşça kal.
non intellego – anlamıyorum/anlamadım.
quomodo Latine hoc dicis – bunun Latince'si nedir?
scisne ... – ... biliyor musunuz?
Anglice – İngilizce
Francogallice – Fransızca
Latine – Latince
ego – ben
meus – benim
me, mihi – beni, bana
tu – sen
ille - o
nos – biz
vos – siz (etiam "tu" forma urbana)
illi - o
quid nomen tibi est? – adınız nedir?/Sizin adınız ne?
quid agis? – ne yapıyorsunuz?
valesne – nasılsınız?
bene – iyi
male – kötü
maritus – koca
proles – çocuklar
mater – anne
pater – baba
amicus / amica – arkadaş
ubi sunt loca secreta? – tuvaletler nerede?
ante - önce
post - 