Als Paronyme bezeichnet man verwechselbar ähnliche Wörter innerhalb einer Sprache und ihrer Dialekte. Zurückgehend auf einen Vorschlag von Jean Bertrand wird ein Paronym in Analogie zum falschen Freund, der sich auf Fremdsprachen bezieht, auch als falscher Bruder bezeichnet. Paronyme entfalten ihre Wirkung in häufigen oder geläufigen Missverständnissen, die regelmäßig wiederkehren, oft lange bestehen bleiben und auch punktuell auftreten können, oder das Lernen der jeweiligen Sprache erschweren.
Welche Wörter im Einzelnen als paronym zueinander empfunden werden, hängt vom Ausbildungsstand und vom sozialen, regionalen wie sprachlichen Umfeld der beteiligten Sprecher ab. Auch die Sprachwissenschaft kennt mehrere Definitionen und Zugänge zum Phänomen des Paronyms; die Paronymie als solche ist noch ungenügend erforscht. Paronyme eignen sich für Witze und Sprachspiele, weil sich ihre Sinngebung leicht einem Zusammenhang unterstellt, aus dem sie danach aber überraschend wieder herausgeholt wird.
Eine Unterklasse der Paronyme sind die Homophone, die in Anlehnung an ein Ratespiel auch Teekesselchen genannt werden.


== BeispieleBearbeiten ==


=== DeutschBearbeiten ===
adoptieren – adaptieren
Antarktika – Antarktis
Cellulite – Zellulitis
Deprivation – Depravation
Preis – Preiß (bairisch für Preuße)
Rezension – Rezession
Reverenz – Referenz
Intension – Intention
Parodontose – Parodontitis
Versprecher – Versprechen


=== EnglischBearbeiten ===
Australia – Austria
conjuncture – conjecture
night – knight
quarrel – quarry
worse - worth


=== FranzösischBearbeiten ===
antiseptique – aseptique
amoral – immoral
je veux - cheveux
(j'veux - cheveux)
t'as - ta
(ça) soit - soit (l'un soit l'autre)
j'irai - j'irais
la morte d'elle - la mortelle - l'immortelle
c'est - (il) s'est
quand être - connaître


=== LitauischBearbeiten ===
Farmacija – formacija
Kompanija – kampanija


=== PolnischBearbeiten ===
adaptować – adoptować


=== BulgarischBearbeiten ===
Австралия – Австрия
боксувам – буксувам
указвам – оказвам


=== RussischBearbeiten ===
Австралия – Австрия
указывать – оказывать


=== UngarischBearbeiten ===
ateista – autista
adaptál – adoptál
allegória – filagória


== Siehe auchBearbeiten ==
Homophon
Homograph
Homonym
Kognat
Wortgleichung


== LiteraturBearbeiten ==
Harald Kipp: Non-Verwexlexikon: Englische Vokabeln, die am häufigsten verwechselt werden. 3., stark erw. Neuausg., Lübbe, Bergisch-Gladbach 1991, ISBN 3-404-66208-3
Ioan Lăzărescu: Die Paronymie als lexikalisches Phänomen und die Paronomasie als Stilfigur im Deutschen. Editura Anima, Bukarest 1999, ISBN 973-9053-42-4
Wolfgang Mentrup: Mahlen oder malen? Gleichklingende, aber verschieden geschriebene Wörter. Bibliographisches Institut, Mannheim (u.a.) 1971 (= Du